type octile
height 6
width 13
map4
.............
.....@.......
....@........
...@.........
.............
.............